type octile
height 10
width 10
map
TTTTTTTTTT
T..T..T..T
TT...TTT.T
T........T
T........T
T.T...T..T
T..T...T.T
T....TTT.T
T.T..T...T
TTTTTTTTTT